1 1 1 1 1 1 1 1 1 1 1 1 1 1 1 1 1 1 1 1 1 1 1 1
1 _ _ _ _ _ 2 _ _ _ _ _ _ _ _ _ _ 4 _ _ _ _ _ 1
1 _ 2 2 _ _ _ _ _ 2 2 2 _ _ _ 3 _ _ _ _ 4 _ _ 1
1 _ _ _ _ _ _ _ _ _ _ 2 2 _ _ _ 3 _ _ _ _ _ _ 1
1 _ 2 2 _ _ _ _ _ _ _ _ 2 _ 4 _ _ 3 _ _ _ 4 _ 1
1 _ _ _ _ _ 4 _ _ 2 2 _ 2 _ _ _ _ _ _ 4 _ _ _ 1
1 _ 3 _ _ _ 2 _ _ 2 _ _ 2 _ _ _ 4 _ _ _ _ 4 _ 1
1 _ _ 3 _ _ 2 _ _ _ _ _ _ _ _ _ _ _ _ _ _ _ _ 1
1 _ 3 _ _ _ _ _ _ _ 3 _ _ 3 3 _ _ _ _ 3 3 _ _ 1
1 _ 3 _ _ _ 3 3 _ 3 _ _ _ 3 3 _ _ _ _ 2 3 _ _ 1
1 _ _ _ _ 3 _ 3 _ _ 3 _ _ _ _ _ _ _ _ _ _ _ _ 1
1 _ 4 _ 3 _ _ _ _ 3 _ _ 2 _ _ _ _ _ _ _ _ 2 _ 1
1 _ _ _ _ _ 4 _ _ _ _ _ 2 2 _ _ _ _ _ _ 2 2 _ 1
1 _ _ 4 _ _ _ _ 4 _ _ _ _ 2 2 2 2 2 2 2 2 _ _ 1
1 _ _ _ _ _ _ _ _ _ 4 _ _ _ _ _ _ _ _ _ _ _ _ 1
1 1 1 1 1 1 1 1 1 1 1 1 1 1 1 1 1 1 1 1 1 1 1 1